WWWWWWWWWWWWWWWWWWW
W00000000000000000W
W00000000000000000W
W00000000000000000W
W00000000000000000W
W00000000000000000W
W00000000000000000W
W00000000000000000W
W000000000000000000
W000000000000000000
W00000000000000000W
W00000000000000000W
W00000000000000000W
W00000000000000000W
W00000000000000000W
W00000000000000000W
W00000000000000000W
WWWWWWWWWWWWWWWWWWW